#################
#     XX    XX  #
# #X#X#X#X# # # #
#X  w XX  X   XX#
# #X#X# #X# # # #
# X    X X   XbX#
# # #X# # #X#X#X#
# X   X bXX  X  #
#X# # #X# #X# # #
#X    d   XXX XX#
#################
