###############
#  bX        X#
# # # # # #w# #
# XX  X  X   d#
# # # # # #X# #
#XX    X  XX X#
# #X# # #X# # #
#   XX        #
###############
