#####################
#   XX  X X X w  X  #
# # # #X# # #b# # #X#
#X  X X  XX XX  X   #
# #X# #X# # # # # #X#
# X   X  XXX      X #
#X#X#X# # # # # # #X#
#XX XX X    wX    X #
# # #X#X# #X# # #X#X#
#     X    XX  XXX X#
# # #X#X# # # # # #X#
#   XX bX XX  X XdXX#
#X# #X# # # #X#X# #X#
#XXXXX  X X   X     #
#####################
