###########
#  X  X   #
# # # # # #
#  X XwX  #
# #X#X#X# #
#     d X #
###########
